222222222222222222
211111111111111112
212222222222222212
212411111111111112
212231222222222222
211121111111111122
211112111111112122
211111221111112112
211111121111121112
211111121111121112
211111221111112112
211112111111112122
211121111111111122
212211222222222222
212211111111111112
212222222222222212
211111111111111112
222222222222222222