222222222222222222
211111111111111142
211111111111111112
211222222222222112
211111111111112112
211211111111112112
211211222222112112
211211232112112112
211211211112112112
211211211112112112
211211211112112112
211211222211112112
211211111111112112
211211111111112112
211222222222222112
211111111111111112
211111111111111112
222222222222222222