222222222222222222
241112211112211112
211112211112211112
211112211112211112
211112211112211112
211111111111111112
222222112211111222
211111111111111112
211111211112111112
211111211112111112
211111111111111112
222111112211222222
211111111111111112
211112211112211112
211112211112211112
211112211112211112
211112211112211132
222222222222222222