222222222222222222
211211111111111112
211211111111111112
211222221121222112
211222221121211112
211211221121211112
211231111121222112
211112111121111112
241112222222222212
211112222222222212
211112111121111112
211211111121222112
211211221121211112
211222221121211112
211222221121222112
211211111111111112
211211111111111112
222222222222222222