222222222222222222
211111111111111112
211111111111111112
211111112211111112
211111112211111112
211111112211111112
211111112211111112
221211222222222122
221211142222112122
221211222231112122
211111112222112122
212111112211111112
212112112211111112
212222112211111112
212112212211111112
212111112211111112
211111112211111112
222222222222222222