222222222222222222
211111111111221112
211111111111221112
211111111111221112
222222221121221112
222222221121221112
211111111121221112
211122221121221112
211111111111111112
211111131111111112
211122121122221112
211122121111111112
211122121122222222
211122121122222222
211122111111111112
211122111111111112
241122111111111112
222222222222222222