222222222222222222
211111111111111112
212222222222222212
212411111111111212
212111111111111212
212222221122222212
211111121121111112
211111121121111112
211111111111111112
211111111111111112
211111121121111112
211111121121111112
212222221122222212
212111111111111212
212111111111113212
212222222222222212
211111111111111112
222222222222222222