222222222222222222
241111111111111112
211111111111111112
222221122221122222
211111111111111112
211111111111111112
222221122221122222
211111111111111112
212112112112112112
212112112112112112
212112112112112112
212112112112112112
212111111111111112
211111111111111112
222221122221122222
211111211112111132
211111111111111112
222222222222222222