222222222222222222
211112222222221112
211111111111111112
211111111111111112
212112111211211212
211111111111111112
211111111111111112
212311111111111212
211111111111111112
211111212111111112
212111111111111212
212111111111111212
212111121121111212
212111121121111212
212111121121114212
212111121121111212
211122221122221112
222222222222222222